11111111111111
1000111E010001
1C00000111C001
10001111000111
10P00000000C01
11111111111111
