11111
11C11
11E11
10PC1
11111
