11111111111111
10001110010001
1000000001C001
11001111C00101
10P000110001C1
111111111C11E1
1000000000C0C1
1000000001C001
11111111111111
