1111111111111111111111111111111111
1E0000000000000C00000C001100000001
1001001001000001010010001100101011
1111001001010100010010000000101011
110100100C00C001111111000000000C11
1P0000000C00C0000000100000000000C1
1111111111111111111111111111111111
