111111111
1111P1111
C111C1111
C111E111C
111111111
