1111111111
10000000E1
1011111001
1010001001
1010101001
1010101001
1010101001
1010101001
1010101001
1P1C100001
1111111111
